............x.................
............,......,..........
............,......,..........
............,......,..........
...,,,,,,,,,,,,,,@,,,.........
.....,..,.....................
.....,..,......,..............
.....,..,......,..............
.....,..,......,..............
.....,..,......,..............
.....,..,,,,,,,,,,,,,,,,,,....
.....,....,...........,@,,....
.....,....,,,,,,,,,,,,,,,,....
.....,....,.............,.....
.....,,,,,,,,,,,,,.....,@,....
.....,....,......,,,...,,,....
.....,....,........,...,,,....
.....@....,,,,@,,,,,,,,,,,....
.....,....,........,,,,,,,....
.....,,,,,,........,..........
......,............,..........
......,,,,,@,,,,,,,,@,,,......
......,................,......
......,................,......
......,,,,,,,,@,,,,,,,.,......
.............,................
.............,................
............,,,,,,,,..........
..,,,,,,,,,,,.................
......*,,,,...................