......................................x.
.........,,,,,,,,@,........,,,,,@.....,.
.........,,,@,,,,,,,,,,,,,,,....,.....,.
.........,...................,,,,,,,,,,.
.@,,,,,,,,...................,,,,.......
.,.......,...........,,,,,,,,,,,,,@.....
.,.......,....................,,..,.....
.,,,,,,,.,.....................,,,,.....
.......,,,,,,,,,,,,,@,,,,,,,,,,,,.......
.......,......,.....,...........,.......
.......,......,.....,...........,.......
.......,,,,,,,,,@,,,,...........,.......
.......,......,.....,...........,.......
.......,......,.....,...........,.......
.,,,,,,,,,,,,,,,,,,,,,,,,,,,,,,,,,,,....
...@..........@........,.......,........
...,,,,,,,,,,,,,,,,,,,,,,......,........
..,,,,................,........,........
..,...................,,,,,,,,,@........
..,........,,,,,,,,,,,,........,........
..,........,.,........,........,........
..,........,.,....,,,,,,,,,,,,,,,.......
..,........,.,,,,,,,,,,..,......,.......
.,,,,,,,,@,,...........,,,,,,...,.......
..,........,,,,,,,,...,,,@,,,...,.......
..,........,......,...,,,,,,,...,.......
..,........,......,,,,,@,,,,,,,,,.......
..,........@......,...,,,,,,,...,.......
..,,,,,,,,,,......,...,,,,@,,...,.......
..@........,......,...,,,,@,,...,,,,....
.,,,,,,,,,,,,,,,,,,@.....,......,..,....
.,...,...........,,,,,,,,,,,,,,,,..,....
.,...,...........,........,.....,..,....
.,,..,...........,..,,,...,.....,..,,,,.
.,,,,,@,,,,,,,,,,,..,.....,,,,..,.....,.
.....,..............,,....,..,..,...@,,.
.....,,,,,,,,,,,,,,,,,,,,,,,,,,,,,,,,...
..................,.....................
..................,.....................
..................*.....................