................x...
..........,,,,,,,...
..........,,....,...
..........,,...,,...
..........,,,@,,,...
.....,....,,...,,...
...,,,....,.....,...
.....,...,,.....,...
.....,,,,,.....,,...
.....,@,....,..,....
.....,,.....,..,....
.....,,,,,,.,..,,...
.........,,,,,,,,...
.........,...,,@,...
.........,...,......
...,,,,,,,,.,,......
.....,,.....,,,,,,..
.....,,,,,,,,.......
....,,..............
....*...............