..............*.........................
....,,,,,,,,,,,...............,.........
....,.........,..,,,..........,.........
.,,,,,........,....,..........,.........
.....,........,....,..........,.........
.....,,,,,,,,,,,,,,@,,,,,,,,,,,,,,,.....
............,......,..............,.....
...,,,,,,,,,,......,..............,.....
............,......,.....,,,,,,,,,,.....
............,......,.......,............
............,......,.......,,,,,,,......
...@,,,,,,,,,,,,,,,,,,.....,...,........
...,.......................,...,........
...,............,,,,,,@,,,,,,,.,........
...,............,..............,.,,.....
...,,,,,,,,,,,,@,,,,,,,,,......,..,.....
........................@......,..,.....
........................,......,..,.....
........................,......,..,.....
...........,,,,,,,,,,,,,,,,,,,,,..,.....
...............,........,.........,.....
...............,........,.......,,,.....
...............,,,,,....,.......,.......
...............,...,....,.......,.......
.,,,,@,,,,,,,,,,...,,,,,,.......,.......
...............,,.......,@,,,,,,,.......
................,,,,,,,,,...............
......,,,,,,,,,,,.......................
......,.......,,,.......,...............
.....@,.......,@,,,,,,,,,...............
......,.......,.........................
......,.......,..................@......
...,,,,,,,,,,,,,,,,,,,,,,,,......,......
.......,........,.........,......,......
.......,.......,,,,,,,,,,,,......,......
.......,.......,......@...,,,,,,,,......
.......,.......,......,.................
.......,,,,,,,,,......,.................
.............,,,,,,,,,,.................
......................*.................