.x..................
.,,,,,..............
.,,,@,,.............
.,,,*,,.............
.,..................
.@..................
.,..................
,,,,,,,,,,,,,,,,,,,,
.,..................
.,..................
.,..................
.,..................
.,..................
.,..................
.,..................
.,..................
.,..................
.,..................
.,..................
.,..................