......................x.......
...................,,,,,,.....
.........,,@,,,,,,,,,..,,.....
.........,..........,..,......
.........,..........,,,,......
....,,,,,,,,,,,,,,,,@.........
..........,...................
..........,.......,,,,,,,@,,,.
..........,.................,.
..,,,,,,,,,......,,,,,,,,,,.,.
..,................,......,.,.
..,...,,,,,,,,.....,......,.,.
..,...,......*,,,,,,,,,,,,,.,.
..,...,......,..............,.
..,@,,,......,..............,.
..,...,......,..............,.
..,...,......,..............,.
..,...,,@,,,,,,,,,,,,,,,,,,,,.
..,.......,...................
..,.......,,,,,,,,,...........
..,.......,...................
..,.......,............,......
..,,,,,,,,,,,,,@,,,,,,,,......
..........,............,......
..........,............,......
..........,,,,,,,,,,,,,,,,....
............,.................
............,.................
............,,,,,,,,..........
..............................